NO ./textures/wall_1.png
SO ./textures/wall_1.png
WE ./textures/wall_1.png
EA  ./textures/wall_1.png

C 55,100,200
F 0,125,5      

        11111111111111111111111111
        100000000011000001 10000001
      1110110000011100000010000011
      1E100100000000000000100001
1111111110110000011100000000000011
100000000011000001110111111111111
11110111111111011100000010001
11110111111111011101010010001
11000000110101011100000010001
1000000000001 101100000010001
1000000000001 111101010010001
1110000111011 111110111110111
11 10111 1111 111111111011101
11 11111 1111 11111 111110011
        11111111111111111111111111
        100000000011000001 10000001
        10110000011100000010000011
        100100000000000000000001
111111111011000001110000000000001
100000000011000001110111111111111
11110111111111011100000010001
11110111111111011101010010001
11000000110101011100000010001
1000000000001 101100000010001
1000000000001 111101010010001
1110000111011 1111110111110111
11 10111 1111 11111 11101 101
11 11111 1111 11111 11111 111