NO ./textures/eagle.png
SO ./textures/stone.png
WE ./textures/wall_1.png
EA ./textures/wood.png

C 200,0,0
F 0,200,0  

111111111111111111111111111111111111111111111111111111111111111111111111111111111111111111
100000000000000000000000000000000000000000000000000000000000000000000000000000000000000001
100000000000000000000000000000000000000000000000000000000000000000000000000000000000000001
100000000000000000000000000000000000000000000000000000000000000000000000000000000000000001
100000000000000000000000000000000000000000000000000000000000000000000000000000000000000001
100000000000000000000000000000000000000000000000000000000000000000000000000000000000000001
100000000000000000000000000000000000000000000000000000000000000000000000000000000000000001
100000000000000000000000000000000000000000000000000000000000000000000000000000000000000001
100000000000000000000000000000000000000000000000000000000000000000000000000000000000000001
1000000E0000000000000000000000000000000000000000000000000000000000000000000000000000000001
100000000000000000000000000000000000000000000000000000000000000000000000000000000000000001
100000000000000000000000000000000000000000000000000000000000000000000000000000000000000001
100000000000000000000000000000000000000000000000000000000000000000000000000000000000000001
100000000000010000000000000000000000000000000000000000000000000000000000000000000000000001
100000000000110000000000000000000000000000000000000000000000000000000000000000000000000001
100000000000110000000000000000000000000000000000000000000000000000000000000000000000000001
100000000000110000000000000000000000000000000000000000000000000000000000000000000000000001
100000000000110000000000000000000000000000000000000000000000000000000000000000000000000001
100000000000110000000000000000000000000000000000000000000000000000000000000000000000000001
100000000000110000000000000000000000000000000000000000000000000000000000000000000000000001
100000000000110000000000000000000000000000000000000000000000000000000000000000000000000001
100000000000110000000000000000000000000000000000000000000000000000000000000000000000000001
100000000000110000000000000000000000000000000000000000000000000000000000000000000000000001
100000000000110000000000000000000000000000000000000000000000000000000000000000000000000001
100000000000110000000000000000000000000000000000000000000000000000000000000000000000000001
100000000000110000000000000000000000000000000000000000000000000000000000000000000000000001
100000000000110000000000000000000000000000000000000000000000000000000000000000000000000001
100000000000110000000000000000000000000000000000000000000000000000000000000000000000000001
100000000000110000000000000000000000000000000000000000000000000000000000000000000000000001
100000000000110000000000000000000000000000000000000000000000000000000000000000000000000001
100000000000110000000000000000000000000000000000000000000000000000000000000000000000000001
100000000000000000000000000000000000000000000000000000000000000000000000000000000000000001
100000000000000000000000000000000000000000000000000000000000000000000000000000000000000001
100000000000000000000000000000000000000000000000000000000000000000000000000000000000000001
111111111111111111111111111111111111111111111111111111111111111111111111111111111111111111