
NO .fdgdfdsgdsgs
SO ./textures/banner.xpm
WE ./textures/redbrick. xpm
EA  bluestone.xpm

C 4 55,100,200
F 0,125,5      

111111111111111111
100000000000000001
100000000000000001
100000000000000001
100000000000000001
100000000000000001
100000000000000001
100000000000000001
100000000000000001
1000000E0000000001
100000000000000001
100000000000000001
100000000000000001
100000000000010001
100000000000110001
100000000000000001
100000000000000001
100000000000000001
111111111111111111