
NO .fdgdfdsgdsgs
SO ./textures/banner.xpm
WE ./textures/redbrick. xpm
EA  bluestone.xpm

C 4 55,100,200
F 0,125,5      

    1
111111111
100E00001
111111111