NO .fdgdfdsgdsgs
SO ./textures/banner.xpm
WE ./textures/redbrick. xpm
EA  bluestone.xpm

C 4 55,100,200
F 0,125,5      


11111111111111111111111111111
11110000000000000101010010001
11000000110101011100000000001
10000000000010101100000000001
10000000000010111101010000001
11100001110110111111011110001
11010E11011111111110111011101
11111111111111111111111111111
